%%%%%%%%%%%%%%%%%%%%%%
%P                   %
%                    %
%                    %
%                    %
%   .         . ...  %
%    .       .   .   %
%     .......    .   %
%      .   .     .   %
%       . .      .   %
%        .      ...  %
%                    %
%                    %
%                    %
%                    %
%%%%%%%%%%%%%%%%%%%%%%

