%%%%%%%%%%%
%    P  ..%
%.%%%%%%% %
%       ..%
%%%%%%%%%%%