%%%%%%%%%%%%%%%%%%%%%%%%%%%% 
%                     %    %
%                     %    %
%            P        %    %
%                     %%%%%%
%                          %
%            %             %
%            %             %
%            %             %
%%%  %%%%%%%%%%%%%%      %%%
%      %                   %
%      %                   %
%      %                   %
%      %                   %
%      %                   %
%                   %%%%%%%%
%      %                   %
%      %                   %
%      %                   %
%%%%%%%%%%%%%%%%%%%%%%%%%%%%
